GGWGGGGGGGGGGGGGGWWW
GGGWGGGGGGGGGGGGGGWW
GGGGWWGGGGWWGGGGGGGW
RGGGGGWWWWWWGGGGGGGG
RGGGGGGGGWWGGGGGGGGG
RRGGGGGGGGGGGGGRGGGG
RRGGGGGGGGGGGGRGGGGG
RRRGGGGGGGGGGRGGGGGG
RRGGGGRGGGGGGGRGGGGG
GGGGGGGRGRGGGGGGGGRR
GGGGGGGGRGGGGGGGGRRG
GWWWWGGRGGGGGGGGRRGG
WWGGGGGGGGGWGGGGGGGG
GGGGGGGWWWWWGGGGGGGG
GGGGGGGWWWWWWGGGGGGG
GGGGGGGGGWWWWGGGGGGG
GGGGGGGRGGGGGGGGGGGG
GGGGGGGGRGGGGGGGGGGG
GGGGGGGGGGGGGGGGGGGG
GGGGGGRGGGGGGGGGGGGG
GGGGGRGGGGGGGGGGGGGG
GGGGRGGGGGGGGGGGGGGW
GGGGGGGGGGGGGGWWWWWW
WGGGGGGGGGGWWWWWWRRR
WGGGGGGGWWWWWWWWRRRR