WWWNWNWNNNNNNNNNNNNN
NNNNWNNNNNNNNNNNNNNN
NNNNNNNNNNNNNNNNNNNN
NNNNNNNNNNNNNNNNNNNN
NNNNWNWNNNNNNNNNNNNN
NNNWNNNNWNNNNNNNRNNN
NNNNNNNWNNNNNNNNNNNN
NNNNNNNNNNNNNNRNNNNN
NNNWNNNWNNNNNRNNNNNN
NNNNNNNNWNNNNWNNNRNN
NNNWWNNNNNNNNNNNNNNN
NNNWNNNNNWNNNNNWNNNN
NNNNNNNNNNNNNNNNWNNN
NNNWNNNNNNNNNNNNNNWN
NNNNNNWNNNNNNNNNNNNN
NNNNNNWNNNWNNNNNNNNN
NNNNNNNNNNNNNNNNNNNN
NNNNNNNNWNNNNNNNNNNN
NNNNNNNNNNNNNNNNNNNN
NNNNNNNNNNNNNNNNNNNN
NNNNWNNNNNNNNNNNNNNN
NNNNNWNNNNNNNNNNNNNN
NNNNNNNNNNNNNNNNNNNN
NNNNNNNNNNNNNNNNNNNN
NNNNNNNNNNNNNNNNNNNN
